11111111
1C000001
11111101
1E000C01
11111111
