11111111
1C000001
11111101
1E000CP1
11111111
