11111111
10000001
10C0C001
10E00P01
11111111
